0000000000000000000000000000000000000000
0000000000000000000000000000000000000000
0000000000000000000000000000000000000000
0000000000000000000000000000000000000000
0000000000000000000000000000000000000000
0000000000000000000000000000000000000000
0000000000000000000000000000000000000000
0303030303030303030300000000000000000000
0303030303030303030300000000000000000000
0303030303030303030300000000000000000000
0303030303030303030300000000000000000000
0303030300000000000000000000000000000000
0303030300000000000000000000000000000000
0303030300000000000000000000000000000000
0303030300000000000000000000000000000000
0303030303030303030300000000000000000000
0303030303030303030300000000000000000000
0303030303030303030300000000000000000000
0303030303030303030300000000000000000000
0000000000000000000000000000000000000000
0000000000000000000000000000000000000000
0000000000000000000000000000000000000000
0000000000000000000000000000000000000000
0000000000000000000000000000000000000000
0000000000000000000000000000000000000000